Hisuian Growlithe	MultiDiegoDani
Hisuian Arcanine	MultiDiegoDani
Hisuian Voltorb	MultiDiegoDani
Hisuian Electrode	MultiDiegoDani
Hisuian Typhlosion	MultiDiegoDani
Hisuian Qwilfish	MultiDiegoDani
Hisuian Sneasel	MultiDiegoDani
Hisuian Samurott	MBCMechachu
Hisuian Lilligant	MultiDiegoDani
Hisuian Zorua	MultiDiegoDani
Hisuian Zoroark	MultiDiegoDani
Hisuian Braviary	MultiDiegoDani
Hisuian Sliggoo	MBCMechachu
Hisuian Goodra	MBCMechachu
Hisuian Avalugg	MultiDiegoDani
Hisuian Decidueye	MultiDiegoDani
Basculin - White Stripe	MultiDiegoDani
Wyrdeer	MultiDiegoDani
Kleavor	MBCMechachu
Ursaluna	MBCMechachu
Basculegion	MultiDiegoDani
Sneasler	MBCMechachu
Overqwil	MultiDiegoDani
Enamorus - Incarnate Form	MultiDiegoDani
Enamorus - Therian Form	MultiDiegoDani
